15 15
111111111111111
100000000000001
101111111111101
100000000000001
111100000001111
100000010000001
100100111001001
100100010001001
100110000011001
100000000000001
101111101111001
101000020001001
101111101111101
100000000000001
111111111111111
1 1