10 10
0000000000
0111111111
0000100210
0010101010
0010101010
0010101010
0010101010
0010001010
1011111010
0000000000
0 1