12 20
11111111111111111111
10000000000000000001
10000000000000002001
11111111110011111111
10000000000000000001
10111111111111111101
10000000000000000001
11111111111100111111
10000000000000000001
10111110011111111101
10000000000000000001
11111111111111111111
11 4