10 15
011111111111111
000000000000001
111111111111101
100000000000101
101111111110101
101000020000101
101000000000101
101111111111101
100000000000001
111111111111111
0 0