7 12
111111111111
100000000001
101110011031
100001000101
100303010001
100201010101
013100000111
2 5