12 15
111111111111111
100000000000001
111110000011111
100000010000001
101000010000101
103011111110001
100000010000001
100100010010001
131111000111001
100120030010001
100000000000001
111111111111111
1 1