12 15
111111111111111
100000000000001
101113000311101
100000313000001
101000010000101
100011111110001
100000010000001
100100010010001
101111020111001
100100000010001
100000030000001
111111111111111
1 1