12 15
111111111111111
100000000000001
100111111111001
100030000000001
111001101100111
130011000110001
111001101100111
100000003000001
100111111111001
100100020001001
100003111000001
111111111111111
5 7