10 10
0000000000
0111111113
0000000000
0011101110
0001101010
3300001010
0010131011
0000001010
1012111010
0000000000
0 9