10 12
101110101101
100022000031
100111100001
002003000000
111100011101
000221113000
101002200001
001000001100
100033300001
101110101101
9 5