10 12
101110101101
102222222231
100111122221
002003000200
111100011101
020001113000
121000020001
001003001100
122222222221
101110101101
0 1