7 12
101110101111
120303030301
100202020201
111111111101
120202020201
100303030301
111111111111
0 1