10 10
1010101010
1222030220
1011021101
1020222001
0030112201
0201111200
0220000221
1221000321
1222222220
1010101010
3 3