11 13
1111110111111
1000000000001
1000001000001
1110301030111
1222000002221
1000020200001
1003003003001 
1000220220001 
1003003003001 
1000000000001
1111111111111
0 6