10 12
111111111111
100002230031
101211212101
101211010101
102222222221
101012011121
121012220021
121212211121
132222200021
111111111111
1 1