16 19
1111111111111111111
1000000003003222221
1211212121012121121
1222212221222122221
1211211121211121121
1212222220222222121
1212112110112112121
1222222200022222221
1211212102012121121
1211202130312021121
1222010100010102221
1211012222222121121
1201000111110001001
1001000001000001001
1000011101011100001
1111111111111111111
1 10