10 10
1111111111
1222222221
1211001101
1222230001
1011201101
1200011031
1211000221
1010230121
1222222221
1111111111
0 1