17 19
1111111111111111111
1011222020212111121
1000100001222122221
1010011121211121121
1212222221222222121
1212112111111112121
1222222000002222221
1211212100012121121
1211212133312121121
1222212111112122221
1211012000002121121
1221010111112121221
1221000001222221221
1211011101211121121
1210000001222222121
1022222222222222221
1111111111111111111
16 1