13 19
1111111111111111111
1000000120212222231
1211212121212121121
1222212221222122221
1211211121211121121
1212222221222222121
1212112111112112121
1222222222222222221
1211212102012121121
1211212133312121121
1222000111110002221
1222222222222222221
1111111111111111111
1 9